Garlic Butter Mushrooms | Ingredients: mushrooms, garlic, butter, parsley, salt, black pepper
Creamy Coleslaw | Ingredients: cabbage, carrot, mayonnaise, vinegar, sugar, salt, pepper
Cilantro Lime Rice | Ingredients: rice, cilantro, lime juice, lime zest, salt
Maple Roasted Carrots | Ingredients: carrots, maple syrup, olive oil, salt, pepper
Parmesan Zucchini Fries | Ingredients: zucchini, parmesan cheese, eggs, salt, pepper
Cheesy Cauliflower Bake | Ingredients: cauliflower, cream cheese, cheddar cheese, garlic, salt, pepper
Spicy Sweet Potato Wedges | Ingredients: sweet potatoes, olive oil, chili powder, salt
Saut√©ed Green Beans | Ingredients: green beans, garlic, olive oil, salt, pepper
Caprese Salad Skewers | Ingredients: cherry tomatoes, mozzarella balls, balsamic vinegar, basil
Broccoli and Cheese Stuffed Potatoes | Ingredients: potatoes, broccoli, cheddar cheese, milk, salt, pepper
Corn and Black Bean Salad | Ingredients: corn kernels, black beans, lime juice, olive oil, salt, pepper
Balsamic Brussels Sprouts | Ingredients: Brussels sprouts, balsamic vinegar, honey, olive oil, salt, pepper
Stuffed Bell Peppers | Ingredients: bell peppers, rice, tomato, ground beef, garlic, cheese
Roasted Beet and Feta Salad | Ingredients: beets, feta cheese, olive oil, balsamic vinegar, salt, pepper
Greek Style Lemon Potatoes | Ingredients: potatoes, lemon juice, olive oil, garlic, oregano, salt, pepper
Spinach and Cheese Stuffed Mushrooms | Ingredients: mushrooms, spinach, cream cheese, garlic, salt, pepper
Herbed Couscous | Ingredients: couscous, chicken broth, lemon zest, parsley, salt
Cucumber Dill Salad | Ingredients: cucumber, dill, yogurt, garlic, lemon juice, salt, pepper
Quinoa Tabbouleh | Ingredients: quinoa, parsley, tomato, cucumber, lemon juice, olive oil, salt
Butternut Squash Soup | Ingredients: butternut squash, onion, garlic, chicken broth, cream, salt, pepper
Garlic Parmesan Asparagus | Ingredients: asparagus, parmesan cheese, garlic, olive oil, salt, pepper
Mashed Sweet Potatoes | Ingredients: sweet potatoes, butter, milk, cinnamon, salt
Sesame Ginger Bok Choy | Ingredients: bok choy, sesame oil, soy sauce, garlic, ginger, sesame seeds
Cheesy Polenta | Ingredients: polenta (cornmeal), chicken broth, cheddar cheese, butter, salt, pepper
Pesto Pasta Salad | Ingredients: pasta, pesto sauce, cherry tomatoes, parmesan cheese
Honey Glazed Baby Carrots | Ingredients: baby carrots, honey, butter, parsley, salt, pepper
Mediterranean Chickpea Salad | Ingredients: chickpeas, cucumber, tomato, onion, feta cheese, olive oil, lemon juice, parsley
Fried Green Tomatoes | Ingredients: green tomatoes, eggs, flour, milk, salt, pepper, vegetable oil
Crispy Onion Rings | Ingredients: onions, flour, eggs, milk, salt, pepper, vegetable oil
Apple Walnut Salad | Ingredients: mixed greens, apples, walnuts, blue cheese, vinegar, olive oil